--------
--------
---2--x-
--------
-2------
--1-2---
--------
--------