--------------
----33--------
--------------
--2-----------
-------1--3---
--------------
--x-1---------
-3----1-------
------1-------
---1----1--3--
--1-----------
---------3----
-----2--1-----
--------------