----------
---33-----
----1--4--
-------4--
----------
-----x--1-
--1-------
--------1-
-----11---
----------