---------
--21-3---
-------4-
----x----
-1-------
----1-1--
--1------
---1-----
---------