--------
--------
----11--
-1----x-
---11---
--1-----
--------
--------