----------
----------
------1---
-3--------
--------5-
-1---1-x--
---3------
----2-----
--2-------
----------