---------
---------
-1--x--1-
-----2---
-------4-
---1-----
--3----1-
-----21--
---------