----------
---2------
--------4-
-2-----1--
----1-----
-----x----
-4--------
-3--------
-----1----
----------