---------
-------x-
---2-----
--1----11
--1------
-2-------
-----23--
---31----
---------