----------
-----1----
----1-----
----1-----
----1--x--
----1-----
------11--
---1------
-----1----
----------