---------
------1--
-3-------
-------3-
--1--x-1-
--1------
-------3-
----3----
---------