---------
---3-----
--2-3----
-----2---
---------
-------3-
-x--1--1-
------1--
---------