----------
----------
--x----2--
----------
-------1--
-------3--
---23-----
-----23---
----------
----------