------------
------------
------1-----
----11-111--
---1-----1--
---1-----1--
--1---x--1--
---1--------
---1--------
---1111-----
------------
------------