--------
--------
---1----
-x----1-
-----1--
--2-2---
--------
--------