---------
---------
----213--
--21-----
-2-------
---------
---2---x-
---------
---------