----------
----3-----
----------
--1-------
------1-2-
-6--------
-4--------
--13------
--------x-
----------