------------
---4--------
------------
------------
-----1------
-------2----
-------4----
-2--x-------
----------4-
------------
------3-----
------------