----------
-----1----
--2-------
--------4-
---3------
---2---1--
-----x----
---22-----
------1---
----------