----------
---2------
----1-----
--1-------
---1--x---
----1-----
----1-1---
-------1--
-----1----
----------