---------
---21----
--1--11--
-2-----1-
-2-------
--1------
--1------
--12---x-
--1------