---------
-----1---
--21-----
-------1-
---x---1-
-1-----3-
------1--
---1-----
----3----