-----------
---1-------
------3----
-------3---
----2------
---x-------
-------2---
-------2---
---1-1-----
-----1-----
-----------