-----------
-----------
---3-------
-----1-----
------11---
-1--x----1-
------11---
-----1-----
--2--------
-----------
-----------