--------
--------
----12--
---1----
--1-----
------3-
--x-----
--------