----------
----2---x-
----------
---3------
-4------2-
----------
------11--
-------1--
-----2----
----------