----------
----1-----
-----3----
--1---1---
----x-----
--1-------
----11----
------2---
---1------
----------