------------
------------
------------
-----2------
--2---------
--1-----1-1-
-31------1--
---1--------
----x-1-----
------2-----
------------
------------