----------
------2---
---x-1----
--------2-
--------3-
----------
--12------
-3--------
----23----
----------