----------
----------
---3-1----
-----2----
--------3-
1---x---1-
--1----1--
----1-----
----------
----------