-------------
----3--------
-------------
-------------
----2-3------
-------------
-------------
-------1-4---
---2---------
--------1----
-----x---2---
--------1----
-------------