--------
---2----
----12--
---3----
--21----
---1-1--
---1----
-----x--